000 000 000 000 000 000 000 000 000 000 000 000 000 000 000 000 000 000 000 000 000 000 000 000 000 000 000 000 000 000 000 000 001 002 003 002 002 004 005 002 002 006 007 002 002 008 002 009 000 000 000 000 000 000 000 000 000 000 000 000 000 000 000 000 000 000 000 000 000 000 000 000 000 000 000 000 000 000 000 000 000 000 000 000 000 000 000 000 000 000 000 000 000 000 000 000
000 000 000 000 000 000 000 000 000 000 000 000 000 000 000 000 000 000 000 000 000 000 000 000 000 000 000 000 000 000 000 000 011 012 013 014 015 016 017 018 018 019 020 021 022 023 024 025 000 000 000 000 000 000 000 000 000 000 000 000 000 000 000 000 000 000 000 000 000 000 000 000 000 000 000 000 000 000 000 000 000 000 000 000 000 000 000 000 000 000 000 000 000 000 000 000
000 000 000 000 000 000 000 000 000 000 000 000 000 000 000 000 000 000 000 000 000 000 000 000 000 000 000 000 000 000 000 000 011 028 099 099 099 099 099 099 099 099 099 099 099 099 030 025 000 000 000 000 000 000 000 000 000 000 000 000 000 000 000 000 000 000 000 000 000 000 000 000 000 000 000 000 000 000 000 000 000 000 000 000 000 000 000 000 000 000 000 000 000 000 000 000
000 000 000 000 000 000 000 000 000 000 000 000 000 000 000 000 000 000 000 000 000 000 000 000 000 000 000 000 000 000 000 000 032 033 099 099 099 099 099 099 099 099 099 099 099 099 034 035 000 000 000 000 000 000 000 000 000 000 000 000 000 000 000 000 000 000 000 000 000 000 000 000 000 000 000 000 000 000 000 000 000 000 000 000 000 000 000 000 000 000 000 000 000 000 000 000
000 000 000 000 000 000 000 000 000 000 000 000 000 000 000 000 000 000 000 000 000 000 000 000 000 000 000 000 000 000 000 000 038 039 099 099 099 099 099 099 099 099 099 099 099 099 045 046 000 000 000 000 000 000 000 000 000 000 000 000 000 000 000 000 000 000 000 000 000 000 000 000 000 000 000 000 000 000 000 000 000 000 000 000 000 000 000 000 000 000 000 000 000 000 000 000
000 000 000 000 000 000 000 000 000 000 000 000 000 000 000 000 000 000 000 000 000 000 000 000 000 000 000 000 000 000 000 000 011 047 099 099 099 099 099 099 099 099 099 099 099 099 052 025 000 000 000 000 000 000 000 000 000 000 000 000 000 000 000 000 000 000 000 000 000 000 000 000 000 000 000 000 000 000 000 000 000 000 000 000 000 000 000 000 000 000 000 000 000 000 000 000
000 000 000 000 000 000 000 000 000 000 000 000 000 000 000 000 000 000 000 000 000 000 000 000 000 000 000 000 000 000 000 000 053 054 099 099 099 099 099 099 099 099 099 099 099 099 053 054 000 000 000 000 000 000 000 000 000 000 000 000 000 000 000 000 000 000 000 000 000 000 000 000 000 000 000 000 000 000 000 000 000 000 000 000 000 000 000 000 000 000 000 000 000 000 000 000
000 000 000 000 000 000 000 000 000 000 000 000 000 000 000 000 000 000 000 000 000 000 000 000 000 000 000 000 000 000 000 000 061 062 099 099 099 099 099 099 099 099 099 099 099 099 063 064 000 000 000 000 000 000 000 000 000 000 000 000 000 000 000 000 000 000 000 000 000 000 000 000 000 000 000 000 000 000 000 000 000 000 000 000 000 000 000 000 000 000 000 000 000 000 000 000
000 000 000 000 000 000 000 000 000 000 000 000 000 000 000 000 000 000 000 000 000 000 000 000 000 000 000 000 000 000 000 000 011 065 099 099 099 099 099 099 099 099 099 099 099 099 066 025 000 000 000 000 000 000 000 000 000 000 000 000 000 000 000 000 000 000 000 000 000 000 000 000 000 000 000 000 000 000 000 000 000 000 000 000 000 000 000 000 000 000 000 000 000 000 000 000
000 000 000 000 000 000 000 000 000 000 000 000 000 000 000 000 000 000 000 000 000 000 000 000 000 000 000 000 000 000 000 000 011 067 068 069 070 071 072 080 081 074 075 076 077 078 079 025 000 000 000 000 000 000 000 000 000 000 000 000 000 000 000 000 000 000 000 000 000 000 000 000 000 000 000 000 000 000 000 000 000 000 000 000 000 000 000 000 000 000 000 000 000 000 000 000
000 000 000 000 000 000 000 000 000 000 000 000 000 000 000 000 000 000 000 000 000 000 000 000 000 000 000 000 000 000 000 000 082 083 084 083 083 085 086 091 091 087 088 083 083 089 083 090 000 000 000 000 000 000 000 000 000 000 000 000 000 000 000 000 000 000 000 000 000 000 000 000 000 000 000 000 000 000 000 000 000 000 000 000 000 000 000 000 000 000 000 000 000 000 000 000
000 000 000 000 000 000 000 000 000 000 000 000 000 000 000 000 001 002 003 002 002 004 005 002 002 006 007 002 002 008 002 009 001 002 003 002 002 004 005 010 010 006 007 002 002 008 002 009 001 002 003 002 002 004 005 002 002 006 007 002 002 008 002 009 000 000 000 000 000 000 000 000 000 000 000 000 000 000 000 000 000 000 000 000 000 000 000 000 000 000 000 000 000 000 000 000
000 000 000 000 000 000 000 000 000 000 000 000 000 000 000 000 011 012 013 014 015 016 017 018 018 019 020 021 022 023 024 025 011 012 013 014 015 016 017 026 027 019 020 021 022 023 024 025 011 012 013 014 015 016 017 018 018 019 020 021 022 023 024 025 000 000 000 000 000 000 000 000 000 000 000 000 000 000 000 000 000 000 000 000 000 000 000 000 000 000 000 000 000 000 000 000
000 000 000 000 000 000 000 000 000 000 000 000 000 000 000 000 011 028 029 029 029 029 029 029 029 029 029 029 029 029 030 025 011 028 029 029 029 029 029 029 029 029 029 029 029 029 030 025 011 028 029 029 029 029 029 029 029 029 029 029 029 029 030 025 000 000 000 000 000 000 000 000 000 000 000 000 000 000 000 000 000 000 000 000 000 000 000 000 000 000 000 000 000 000 000 000
000 000 000 000 000 000 000 000 000 000 000 000 000 000 000 000 032 033 029 029 029 029 029 029 029 029 029 029 029 029 034 035 032 033 029 029 029 029 029 029 029 029 029 029 029 029 034 035 032 033 029 044 029 044 029 044 044 029 044 029 044 029 034 035 000 000 000 000 000 000 000 000 000 000 000 000 000 000 000 000 000 000 000 000 000 000 000 000 000 000 000 000 000 000 000 000
000 000 000 000 000 000 000 000 000 000 000 000 000 000 000 000 038 039 029 029 029 029 029 044 044 029 029 029 029 029 040 041 042 043 029 029 029 029 029 044 044 029 029 029 029 029 040 041 042 043 029 029 029 029 029 029 029 029 029 029 029 029 045 046 000 000 000 000 000 000 000 000 000 000 000 000 000 000 000 000 000 000 000 000 000 000 000 000 000 000 000 000 000 000 000 000
000 000 000 000 000 000 000 000 000 000 000 000 000 000 000 000 011 047 029 029 029 029 029 044 044 029 029 029 029 029 048 049 050 051 029 029 029 029 029 044 044 029 029 029 029 029 048 049 050 051 029 044 029 044 029 044 044 029 044 029 044 029 052 025 000 000 000 000 000 000 000 000 000 000 000 000 000 000 000 000 000 000 000 000 000 000 000 000 000 000 000 000 000 000 000 000
000 000 000 000 000 000 000 000 000 000 000 000 000 000 000 000 053 054 029 029 029 029 029 044 044 029 029 029 029 029 055 056 057 058 029 029 029 029 029 044 044 029 029 029 029 029 055 056 057 058 029 029 029 029 029 029 029 029 029 029 029 029 059 060 000 000 000 000 000 000 000 000 000 000 000 000 000 000 000 000 000 000 000 000 000 000 000 000 000 000 000 000 000 000 000 000
000 000 000 000 000 000 000 000 000 000 000 000 000 000 000 000 061 062 029 029 029 029 029 029 029 029 029 029 029 029 063 064 061 062 029 029 029 029 029 029 029 029 029 029 029 029 063 064 061 062 029 044 029 044 029 044 044 029 044 029 044 029 063 064 000 000 000 000 000 000 000 000 000 000 000 000 000 000 000 000 000 000 000 000 000 000 000 000 000 000 000 000 000 000 000 000
000 000 000 000 000 000 000 000 000 000 000 000 000 000 000 000 011 065 029 029 029 029 029 029 029 029 029 029 029 029 066 025 011 065 029 029 029 029 029 029 029 029 029 029 029 029 066 025 011 065 029 029 029 029 029 029 029 029 029 029 029 029 066 025 000 000 000 000 000 000 000 000 000 000 000 000 000 000 000 000 000 000 000 000 000 000 000 000 000 000 000 000 000 000 000 000
000 000 000 000 000 000 000 000 000 000 000 000 000 000 000 000 011 067 068 069 070 071 072 080 081 074 075 076 077 078 079 025 011 067 068 069 070 071 072 073 073 074 075 076 077 078 079 025 011 067 068 069 070 071 072 080 081 074 075 076 077 078 079 025 000 000 000 000 000 000 000 000 000 000 000 000 000 000 000 000 000 000 000 000 000 000 000 000 000 000 000 000 000 000 000 000
000 000 000 000 000 000 000 000 000 000 000 000 000 000 000 000 082 083 084 083 083 085 086 091 091 087 088 083 083 089 083 090 082 083 084 083 083 085 086 083 083 087 088 083 083 089 083 090 082 083 084 083 083 085 086 091 091 087 088 083 083 089 083 090 000 000 000 000 000 000 000 000 000 000 000 000 000 000 000 000 000 000 000 000 000 000 000 000 000 000 000 000 000 000 000 000
000 000 000 000 000 000 000 000 000 000 000 000 000 000 000 000 001 002 003 002 002 004 005 010 010 006 007 002 002 008 002 009 000 000 000 000 000 000 000 000 000 000 000 000 000 000 000 000 001 002 003 002 002 004 005 010 010 006 007 002 002 008 002 009 001 002 003 002 002 004 005 002 002 006 007 002 002 008 002 009 000 000 000 000 000 000 000 000 000 000 000 000 000 000 000 000
000 000 000 000 000 000 000 000 000 000 000 000 000 000 000 000 011 012 013 014 015 016 017 026 027 019 020 021 022 023 024 025 000 000 000 000 000 000 000 000 000 000 000 000 000 000 000 000 011 012 013 014 015 016 017 026 027 019 020 021 022 023 024 025 011 012 013 014 015 016 017 018 018 019 020 021 022 023 024 025 000 000 000 000 000 000 000 000 000 000 000 000 000 000 000 000
000 000 000 000 000 000 000 000 000 000 000 000 000 000 000 000 011 028 029 029 029 029 029 029 029 029 029 029 029 029 030 025 000 000 000 000 000 000 000 000 000 000 000 000 000 000 000 000 011 028 029 029 029 029 029 029 029 044 044 044 044 044 030 025 011 028 029 029 029 029 029 029 029 029 029 029 029 029 030 025 000 000 000 000 000 000 000 000 000 000 000 000 000 000 000 000
000 000 000 000 000 000 000 000 000 000 000 000 000 000 000 000 032 033 029 029 029 029 029 029 029 029 029 029 029 029 034 035 000 000 000 000 000 000 000 000 000 000 000 000 000 000 000 000 032 033 029 029 029 029 029 029 029 029 029 044 044 044 034 035 032 033 029 029 044 029 029 029 029 029 029 044 029 029 034 035 000 000 000 000 000 000 000 000 000 000 000 000 000 000 000 000
000 000 000 000 000 000 000 000 000 000 000 000 000 000 000 000 038 039 029 029 029 029 029 044 044 029 029 029 029 029 045 046 000 000 000 000 000 000 000 000 000 000 000 000 000 000 000 000 038 039 029 029 029 029 029 029 029 029 029 029 044 044 040 041 042 043 029 029 029 029 029 029 029 029 029 029 029 029 045 046 000 000 000 000 000 000 000 000 000 000 000 000 000 000 000 000
000 000 000 000 000 000 000 000 000 000 000 000 000 000 000 000 011 047 029 029 029 029 029 044 044 029 029 029 029 029 052 025 000 000 000 000 000 000 000 000 000 000 000 000 000 000 000 000 011 047 029 029 029 029 029 029 029 029 029 029 029 029 048 049 050 051 029 029 029 029 029 029 029 029 029 029 029 029 052 025 000 000 000 000 000 000 000 000 000 000 000 000 000 000 000 000
000 000 000 000 000 000 000 000 000 000 000 000 000 000 000 000 053 054 029 029 029 029 029 044 044 029 029 029 029 029 059 060 000 000 000 000 000 000 000 000 000 000 000 000 000 000 000 000 053 054 029 029 029 029 029 029 029 029 029 029 044 044 055 056 057 058 029 029 029 029 029 029 029 029 029 029 029 029 059 060 000 000 000 000 000 000 000 000 000 000 000 000 000 000 000 000
000 000 000 000 000 000 000 000 000 000 000 000 000 000 000 000 061 062 029 029 029 029 029 029 029 029 029 029 029 029 063 064 000 000 000 000 000 000 000 000 000 000 000 000 000 000 000 000 061 062 029 029 029 029 029 029 029 029 029 044 044 044 063 064 061 062 029 029 044 029 029 029 029 029 029 044 029 029 063 064 000 000 000 000 000 000 000 000 000 000 000 000 000 000 000 000
000 000 000 000 000 000 000 000 000 000 000 000 000 000 000 000 011 065 029 029 029 029 029 029 029 029 029 029 029 029 066 025 000 000 000 000 000 000 000 000 000 000 000 000 000 000 000 000 011 065 029 029 029 029 029 029 029 044 044 044 044 044 066 025 011 065 029 029 029 029 029 029 029 029 029 029 029 029 066 025 000 000 000 000 000 000 000 000 000 000 000 000 000 000 000 000
000 000 000 000 000 000 000 000 000 000 000 000 000 000 000 000 011 067 068 069 070 071 072 080 081 074 075 076 077 078 079 025 000 000 000 000 000 000 000 000 000 000 000 000 000 000 000 000 011 067 068 069 070 071 072 073 073 074 075 076 077 078 079 025 011 067 068 069 070 071 072 080 081 074 075 076 077 078 079 025 000 000 000 000 000 000 000 000 000 000 000 000 000 000 000 000
094 095 096 095 096 095 096 095 096 095 096 095 096 095 096 095 082 083 084 083 083 085 086 091 091 087 088 083 083 089 083 090 000 000 000 000 000 000 000 000 000 000 000 000 000 000 000 000 082 083 084 083 083 085 086 083 083 087 088 083 083 089 083 090 082 083 084 083 083 085 086 091 091 087 088 083 083 089 083 090 000 000 000 000 000 000 000 000 000 000 000 000 000 000 000 000
001 002 003 002 002 004 005 002 002 006 007 002 002 008 002 009 001 002 003 002 002 004 005 010 010 006 007 002 002 008 002 009 001 002 003 002 002 004 005 002 002 006 007 002 002 008 002 009 000 000 000 000 000 000 000 000 000 000 000 000 000 000 000 000 001 002 003 002 002 004 005 002 002 006 007 002 002 008 002 009 000 000 000 000 000 000 000 000 000 000 000 000 000 000 000 000
011 012 013 014 015 016 017 018 018 019 020 021 022 023 024 025 011 012 013 014 015 016 017 026 027 019 020 021 022 023 024 025 011 012 013 014 015 016 017 018 018 019 020 021 022 023 024 025 000 000 000 000 000 000 000 000 000 000 000 000 000 000 000 000 011 012 013 014 015 016 017 018 018 019 020 021 022 023 024 025 000 000 000 000 000 000 000 000 000 000 000 000 000 000 000 000
011 028 029 029 029 029 029 029 029 029 029 029 029 029 030 025 011 028 029 029 029 029 029 029 029 029 029 029 029 029 030 025 011 028 029 029 029 031 031 031 031 031 031 029 029 029 030 025 000 000 000 000 000 000 000 000 000 000 000 000 000 000 000 000 011 028 029 029 029 029 029 029 029 029 029 029 029 029 030 025 000 000 000 000 000 000 000 000 000 000 000 000 000 000 000 000
032 033 029 029 029 029 029 029 029 029 029 029 029 029 034 035 032 033 029 029 029 029 029 029 029 029 029 029 029 029 034 035 032 033 029 036 029 031 036 031 031 037 031 029 037 029 034 035 000 000 000 000 000 000 000 000 000 000 000 000 000 000 000 000 032 033 029 044 029 044 029 044 044 029 044 029 044 029 034 035 000 000 000 000 000 000 000 000 000 000 000 000 000 000 000 000
038 039 029 029 029 029 029 029 029 029 029 029 029 029 040 041 042 043 029 029 029 029 029 029 029 029 029 029 029 029 040 041 042 043 029 029 029 029 029 031 031 029 029 029 029 029 045 046 000 000 000 000 000 000 000 000 000 000 000 000 000 000 000 000 038 039 029 029 029 029 029 029 029 029 029 029 029 029 045 046 000 000 000 000 000 000 000 000 000 000 000 000 000 000 000 000
011 047 029 029 029 029 029 029 029 029 029 029 029 029 048 049 050 051 029 029 029 029 029 029 029 029 029 029 029 029 048 049 050 051 029 036 029 029 036 029 029 037 029 029 037 029 052 025 000 000 000 000 000 000 000 000 000 000 000 000 000 000 000 000 011 047 029 044 029 044 029 044 044 029 044 029 044 029 052 025 000 000 000 000 000 000 000 000 000 000 000 000 000 000 000 000
053 054 029 029 029 029 029 029 029 029 029 029 029 029 055 056 057 058 029 029 029 029 029 029 029 029 029 029 029 029 055 056 057 058 029 029 029 029 029 029 029 029 029 029 029 029 059 060 000 000 000 000 000 000 000 000 000 000 000 000 000 000 000 000 053 054 029 029 029 029 029 029 029 029 029 029 029 029 059 060 000 000 000 000 000 000 000 000 000 000 000 000 000 000 000 000
061 062 029 029 029 029 029 029 029 029 029 029 029 029 063 064 061 062 029 029 029 029 029 029 029 029 029 029 029 029 063 064 061 062 029 036 029 029 036 029 029 037 029 029 037 029 063 064 000 000 000 000 000 000 000 000 000 000 000 000 000 000 000 000 061 062 029 044 029 044 029 044 044 029 044 029 044 029 063 064 000 000 000 000 000 000 000 000 000 000 000 000 000 000 000 000
011 065 029 029 029 029 029 029 029 029 029 029 029 029 066 025 011 065 029 029 029 029 029 029 029 029 029 029 029 029 066 025 011 065 029 029 029 029 029 029 029 029 029 029 029 029 066 025 000 000 000 000 000 000 000 000 000 000 000 000 000 000 000 000 011 065 029 029 029 029 029 029 029 029 029 029 029 029 066 025 000 000 000 000 000 000 000 000 000 000 000 000 000 000 000 000
011 067 068 069 070 071 072 073 073 074 075 076 077 078 079 025 011 067 068 069 070 071 072 073 073 074 075 076 077 078 079 025 011 067 068 069 070 071 072 080 081 074 075 076 077 078 079 025 000 000 000 000 000 000 000 000 000 000 000 000 000 000 000 000 011 067 068 069 070 071 072 080 081 074 075 076 077 078 079 025 000 000 000 000 000 000 000 000 000 000 000 000 000 000 000 000
082 083 084 083 083 085 086 083 083 087 088 083 083 089 083 090 082 083 084 083 083 085 086 083 083 087 088 083 083 089 083 090 082 083 084 083 083 085 086 091 091 087 088 083 083 089 083 090 000 000 000 000 000 000 000 000 000 000 000 000 000 000 000 000 082 083 084 083 083 085 086 091 091 087 088 083 083 089 083 090 000 000 000 000 000 000 000 000 000 000 000 000 000 000 000 000
001 002 003 002 002 004 005 010 010 006 007 002 002 008 002 009 000 000 000 000 000 000 000 000 000 000 000 000 000 000 000 000 001 002 003 002 002 004 005 010 010 006 007 002 002 008 002 009 000 000 000 000 000 000 000 000 000 000 000 000 000 000 000 000 001 002 003 002 002 004 005 010 010 006 007 002 002 008 002 009 000 000 000 000 000 000 000 000 000 000 000 000 000 000 000 000
011 012 013 014 015 016 017 026 027 019 020 021 022 023 024 025 000 000 000 000 000 000 000 000 000 000 000 000 000 000 000 000 011 012 013 014 015 016 017 026 027 019 020 021 022 023 024 025 000 000 000 000 000 000 000 000 000 000 000 000 000 000 000 000 011 012 013 014 015 016 017 026 027 019 020 021 022 023 024 025 000 000 000 000 000 000 000 000 000 000 000 000 000 000 000 000
011 028 102 102 102 102 102 029 029 102 102 102 102 102 030 025 000 000 000 000 000 000 000 000 000 000 000 000 000 000 000 000 011 028 102 102 102 102 102 029 029 102 102 102 102 102 030 025 000 000 000 000 000 000 000 000 000 000 000 000 000 000 000 000 011 028 029 029 029 029 029 029 029 029 029 029 029 029 030 025 000 000 000 000 000 000 000 000 000 000 000 000 000 000 000 000
032 033 102 029 102 029 029 029 029 102 029 029 029 102 034 035 000 000 000 000 000 000 000 000 000 000 000 000 000 000 000 000 032 033 102 029 102 029 029 029 029 102 029 029 029 102 034 035 000 000 000 000 000 000 000 000 000 000 000 000 000 000 000 000 032 033 029 044 044 044 044 029 029 044 044 044 044 029 034 035 000 000 000 000 000 000 000 000 000 000 000 000 000 000 000 000
038 039 102 029 102 029 102 102 029 102 029 102 029 102 045 046 000 000 000 000 000 000 000 000 000 000 000 000 000 000 000 000 038 039 102 029 102 029 102 102 029 102 029 102 029 102 045 046 000 000 000 000 000 000 000 000 000 000 000 000 000 000 000 000 038 039 029 044 029 029 029 029 029 029 029 029 044 029 045 046 000 000 000 000 000 000 000 000 000 000 000 000 000 000 000 000
011 047 029 029 102 029 102 029 029 102 029 102 029 029 052 025 000 000 000 000 000 000 000 000 000 000 000 000 000 000 000 000 011 047 029 029 102 029 102 029 029 102 029 102 029 029 052 025 000 000 000 000 000 000 000 000 000 000 000 000 000 000 000 000 011 047 029 044 029 103 029 029 029 029 104 029 044 029 052 025 000 000 000 000 000 000 000 000 000 000 000 000 000 000 000 000 
053 054 102 029 102 029 102 029 102 102 029 102 029 102 059 060 000 000 000 000 000 000 000 000 000 000 000 000 000 000 000 000 053 054 102 029 102 029 102 029 102 102 029 102 029 102 059 060 000 000 000 000 000 000 000 000 000 000 000 000 000 000 000 000 053 054 029 044 029 029 103 029 029 104 029 029 044 029 059 060 000 000 000 000 000 000 000 000 000 000 000 000 000 000 000 000
061 062 102 029 029 029 102 029 029 029 029 102 029 102 063 064 000 000 000 000 000 000 000 000 000 000 000 000 000 000 000 000 061 062 102 029 029 029 102 029 029 029 029 102 029 102 063 064 000 000 000 000 000 000 000 000 000 000 000 000 000 000 000 000 061 062 029 044 044 044 044 044 044 044 044 044 044 029 063 064 000 000 000 000 000 000 000 000 000 000 000 000 000 000 000 000
011 065 102 102 102 102 102 029 029 102 102 102 102 102 066 025 000 000 000 000 000 000 000 000 000 000 000 000 000 000 000 000 011 065 102 102 102 102 102 029 029 102 102 102 102 102 066 025 000 000 000 000 000 000 000 000 000 000 000 000 000 000 000 000 011 065 029 029 029 029 029 029 029 029 029 029 029 029 066 025 000 000 000 000 000 000 000 000 000 000 000 000 000 000 000 000
011 067 068 069 070 071 072 080 081 074 075 076 077 078 079 025 000 000 000 000 000 000 000 000 000 000 000 000 000 000 000 000 011 067 068 069 070 071 072 080 081 074 075 076 077 078 079 025 000 000 000 000 000 000 000 000 000 000 000 000 000 000 000 000 011 067 068 069 070 071 072 073 073 074 075 076 077 078 079 025 000 000 000 000 000 000 000 000 000 000 000 000 000 000 000 000
082 083 084 083 083 085 086 091 091 087 088 083 083 089 083 090 094 095 096 095 096 095 096 095 096 095 096 095 096 095 096 095 082 083 084 083 083 085 086 091 091 087 088 083 083 089 083 090 000 000 000 000 000 000 000 000 000 000 000 000 000 000 000 000 082 083 084 083 083 085 086 083 083 087 088 083 083 089 083 090 000 000 000 000 000 000 000 000 000 000 000 000 000 000 000 000
001 002 003 002 002 004 005 010 010 006 007 002 002 008 002 009 001 002 003 002 002 004 005 002 002 006 007 002 002 008 002 009 001 002 003 002 002 004 005 010 010 006 007 002 002 008 002 009 000 000 000 000 000 000 000 000 000 000 000 000 000 000 000 000 000 000 000 000 000 000 000 000 000 000 000 000 000 000 000 000 000 000 000 000 000 000 000 000 000 000 000 000 000 000 000 000
011 012 013 014 015 016 017 026 027 019 020 021 022 023 024 025 011 012 013 014 015 016 017 018 018 019 020 021 022 023 024 025 011 012 013 014 015 016 017 026 027 019 020 021 022 023 024 025 000 000 000 000 000 000 000 000 000 000 000 000 000 000 000 000 000 000 000 000 000 000 000 000 000 000 000 000 000 000 000 000 000 000 000 000 000 000 000 000 000 000 000 000 000 000 000 000
011 028 029 029 029 029 029 029 029 044 044 044 044 044 030 025 011 028 029 029 029 029 029 029 029 029 029 029 029 029 030 025 011 028 029 029 029 029 029 029 029 029 029 029 029 029 030 025 000 000 000 000 000 000 000 000 000 000 000 000 000 000 000 000 000 000 000 000 000 000 000 000 000 000 000 000 000 000 000 000 000 000 000 000 000 000 000 000 000 000 000 000 000 000 000 000
032 033 029 029 029 029 029 029 029 029 029 044 044 044 034 035 032 033 029 029 029 029 029 029 044 029 029 029 029 029 034 035 032 033 029 102 102 102 029 029 029 029 102 102 102 029 034 035 000 000 000 000 000 000 000 000 000 000 000 000 000 000 000 000 000 000 000 000 000 000 000 000 000 000 000 000 000 000 000 000 000 000 000 000 000 000 000 000 000 000 000 000 000 000 000 000
038 039 029 029 029 029 029 029 029 029 029 029 044 044 040 041 042 043 029 029 029 029 029 044 029 044 029 029 029 029 040 041 042 043 029 102 029 029 029 029 029 029 029 029 102 029 045 046 000 000 000 000 000 000 000 000 000 000 000 000 000 000 000 000 000 000 000 000 000 000 000 000 000 000 000 000 000 000 000 000 000 000 000 000 000 000 000 000 000 000 000 000 000 000 000 000
011 047 029 029 029 029 029 029 029 029 029 029 029 029 048 049 050 051 029 029 029 029 029 029 105 029 044 029 029 029 048 049 050 106 029 102 029 102 102 102 102 102 102 029 102 029 052 025 000 000 000 000 000 000 000 000 000 000 000 000 000 000 000 000 000 000 000 000 000 000 000 000 000 000 000 000 000 000 000 000 000 000 000 000 000 000 000 000 000 000 000 000 000 000 000 000
053 054 029 029 029 029 029 029 029 029 029 029 044 044 055 056 057 058 029 029 029 029 029 044 029 044 029 029 029 029 055 056 057 058 029 102 029 029 029 029 029 029 029 029 102 029 059 060 000 000 000 000 000 000 000 000 000 000 000 000 000 000 000 000 000 000 000 000 000 000 000 000 000 000 000 000 000 000 000 000 000 000 000 000 000 000 000 000 000 000 000 000 000 000 000 000
061 062 029 029 029 029 029 029 029 029 029 044 044 044 063 064 061 062 029 029 029 029 029 029 044 029 029 029 029 029 063 064 061 062 029 102 102 102 029 029 029 029 102 102 102 029 063 064 000 000 000 000 000 000 000 000 000 000 000 000 000 000 000 000 000 000 000 000 000 000 000 000 000 000 000 000 000 000 000 000 000 000 000 000 000 000 000 000 000 000 000 000 000 000 000 000
011 065 029 029 029 029 029 029 029 044 044 044 044 044 066 025 011 065 029 029 029 029 029 029 029 029 029 029 029 029 066 025 011 065 029 029 029 029 029 029 029 029 029 029 029 029 066 025 000 000 000 000 000 000 000 000 000 000 000 000 000 000 000 000 000 000 000 000 000 000 000 000 000 000 000 000 000 000 000 000 000 000 000 000 000 000 000 000 000 000 000 000 000 000 000 000
011 067 068 069 070 071 072 073 073 074 075 076 077 078 079 025 011 067 068 069 070 071 072 073 073 074 075 076 077 078 079 025 011 067 068 069 070 071 072 073 073 074 075 076 077 078 079 025 000 000 000 000 000 000 000 000 000 000 000 000 000 000 000 000 000 000 000 000 000 000 000 000 000 000 000 000 000 000 000 000 000 000 000 000 000 000 000 000 000 000 000 000 000 000 000 000
082 083 084 083 083 085 086 083 083 087 088 083 083 089 083 090 082 083 084 083 083 085 086 083 083 087 088 083 083 089 083 090 082 083 084 083 083 085 086 083 083 087 088 083 083 089 083 090 000 000 000 000 000 000 000 000 000 000 000 000 000 000 000 000 000 000 000 000 000 000 000 000 000 000 000 000 000 000 000 000 000 000 000 000 000 000 000 000 000 000 000 000 000 000 000 000